ID	class
aardvark	A
antelope	A
bear	B
boar	C
buffalo	A
calf	B
cavy	L
cheetah	A
deer	B
dolphin	A
elephant	B
fruitbat	C
giraffe	A
girl	B
goat	A
gorilla	C
hamster	A
hare	B
leopard	C
lion	A
lynx	B
mink	A
mole	B
mongoose	C
opossum	A
oryx	B
platypus	A
polecat	C
pony	B
porpoise	A
puma	B
pussycat	C
raccoon	A
reindeer	B
seal	C
sealion	A
squirrel	E
vampire	B
vole	A
wallaby	A
wolf	B
chicken	C
crow	A
dove	A
duck	B
flamingo	C
gull	A
hawk	A
kiwi	A
lark	V
ostrich	A
parakeet	C
penguin	D
pheasant	A
rhea	C
skimmer	A
skua	A
sparrow	C
swan	A
vulture	A
wren	B
pitviper	A
seasnake	A
slowworm	B
tortoise	A
tuatara	A
bass	B
carp	A
catfish	A
chub	B
dogfish	B
haddock	B
herring	A
pike	C
piranha	A
seahorse	C
sole	V
stingray	A
tuna	B
frog	C
newt	D
toad	E
flea	A
gnat	B
honeybee	A
housefly	B
ladybird	C
moth	A
termite	E
wasp	A
clam	B
crab	E
crayfish	A
lobster	B
octopus	A
scorpion	D
seawasp	A
slug	B
starfish	C
worm	D
